====================================================================================================
|                                         BLACK HOLE                                               |
|                                                                                                  |
|                 ||                            ||                         ||                      |
|                 ||                            ||                         ||                      |
|                                                                                                  |
|                                                                                                  |
|                                                                                                  |
|                                                                                    ||            |
|                         ||                                                         ||            |
|                         ||                       ||                                              |
|                                                  ||                                              |
|                                                                                                  |
|                                                                            ||                    |
|                  ||                                                        ||                    |
|                  ||                                                                              |
|                                                                                                  |
|                                                                                                  |
|                                                                                                  |
|                                                                    ||                            |
|                            ||                                      ||                            |
|                            ||                                                                    |
|                                                                                                  |
|                                                                                                  |
|                                                                                                  |
|                                                                            ||                    |
|                  ||                                                        ||                    |
|                  ||                                                                              |
|                                                                                                  |
====================================================================================================